   P J P                                            PPPPPPPPPPPPPPPPPPPP                                                                              
   P   P                                            P                  P                                                                              
   P   P                                            P                  P             PPPPPPPPPPPPPPPPPP                                               
PPPP   PPPPPPPPPPPPPPPPPPPPPPPPPPPPPPPPPPPPPPPPPPPPPPPPPPPPPPPPPPPPPP  PPPPPPPPPPPPPPP                PPPPPPPPPPPPPPPPPPPPPPPPPPPPPPPPPPPPPPPPPPPPPPPP
P                                                                                    P H              P                        PPP                   P
P                                                                    M               PPPPPPPPPPPP     P                        PPP                   P
P                                              PPPPP           PPPPPPPPPP    PPPPP                    P                        PPP                   P
P                                                                                P                M   P                        PPP                   P
P                                      PPPPP           PPPPP              P      PPPPPPPPPPPPPPPPPPPPPP                        PPP                   P
P           P  PPPPPPPPPPPPP                                              P                                                    PPP                   P
P           P              P                    PPP                       P                                                                          P
P           P      M       P           M       PPPPP                M     P                                             M                      C     P
PPPPPPPPPPPPPPPPPPPPPP  PPPPPPPPPPPPPPPPPPPPPPPPPPPPPPPPPPPPPPPPPPPPPPPPPPPPPPPPPPPPPPPPPPPPPPPP  PPPPPPPPPPPPPPPPPPPPPPPPPPPPPPPPPPPPPPPPPPPPPPPPPPPP
                     P        P                                    P                                                  P                               
                     P        P                                    P A           M                            M       P                               
                     PPPPPPPPPP                                    PPPPPPPPPPPPPPPPPPPPPPPPPPPPPPPPPPPPPPPPPPPPPPPPPPPP                               