   P   P                                            PPPPPPPPPPPPPPPPPPPP
   P   P                                            P                  P                                                                              
   P   P                                            P                  P             PPPPPPPPPPPPPPPPPP                                               
PPPP   PPPPPPPPPPPPPPPPPPPPPPPPPPPPPPPPPPPPPPPPPPPPPPPPPPPPPPPPPPPPPP  PPPPPPPPPPPPPPP                PPPPPPPPPPPPPPPPPPPPPPPPPPPPPPPPPPPPPPPPPPPPPPPP
P                                                                                    P H              P                       PPP                   P
P                                                                    M               PPPPPPPPPPPP     P                        PPP                   P
P                ppp                           PPPPP           PPPPPPPPPP    PPPPP                    P                        PPP                   P
P                  p                                                               P                M P                        PPP                   P
P               ppppppp                    PPPPP           PPPPP                   PPPPPPPPPPPPPPPPPPPP                        PPP                   P
P      M    P  PPPPPPPPPPPPP                                              P                                                    PPP                   P
P           P              P                    PPP                       P                                                                          P
P           P      M       P           M       PPPPP                M     P                            j                M                      C     P
PPPPPPPPPPPPPPPPPPPPPP  PPPPPPPPPPPPPPPPPPPPPPPPPPPPPPPPPPPPPPPPPPPPPPPPPPPPPPPPPPPPPPPPPPPPPPPP  PPPPPPPPPPPPPPPPPPPPPPPPPPPPPPPPPPPPPPPPPPPPPPPPPPPP
                     P        P                                    P                                                  P
                     P        P                                    P A           M                            M       P
                     PPPPPPPPPP                                    PPPPPPPPPPPPPPPPPPPPPPPPPPPPPPPPPPPPPPPPPPPPPPPPPPPP